0 0 0 1 1 1 1 1 1 1 0 0 0 0 0 0 0 0 0 0 0 0 
0 0 0 1 1 1 1 1 1 0 0 0 0 0 0 0 0 0 0 0 2 2 
0 0 0 1 0 0 0 0 1 1 0 0 0 0 0 0 0 0 0 0 2 2 
0 0 0 1 1 1 0 1 1 1 0 0 0 0 0 0 0 0 0 0 2 0 
0 0 0 0 0 0 0 0 0 0 0 0 0 0 0 0 0 0 0 0 0 0 
0 0 0 0 0 0 0 0 0 0 0 0 1 1 1 1 0 1 1 0 0 0 
0 0 0 0 0 0 0 0 0 0 0 0 1 1 1 1 2 1 1 1 0 0 
0 0 0 0 0 0 0 0 0 0 0 0 0 2 2 1 1 1 1 1 1 0 
2 2 2 0 0 0 0 0 0 0 0 0 0 2 2 1 1 2 1 1 0 0 
2 2 1 0 0 0 0 0 0 0 0 0 0 2 2 1 1 1 1 0 0 0 
0 1 1 1 1 0 0 0 0 0 0 1 0 1 1 1 1 1 0 0 0 0 
0 1 0 0 1 1 0 0 0 0 0 1 1 1 1 1 1 1 0 0 0 0 
0 0 0 0 1 1 0 0 0 0 0 1 1 0 0 1 1 1 0 0 0 0 
0 0 0 0 0 0 0 0 0 0 2 2 1 0 0 0 1 1 1 0 0 0 

0 0 0 0 0 12 0 0 0 0 0 0 0 0 0 0 0 0 0 0 0 0 
0 0 0 0 0 0 0 0 0 0 0 0 0 0 0 0 0 0 0 0 0 0 
0 0 0 0 0 0 0 0 0 0 0 0 8 0 0 0 0 0 0 0 0 0 
7 0 0 0 0 0 0 0 0 0 5 0 4 0 0 0 0 0 0 0 0 0 
0 0 0 6 0 0 0 0 0 0 0 0 0 0 0 0 0 0 0 0 0 0 
0 0 5 0 0 0 5 0 0 0 0 0 0 0 0 0 0 0 0 0 0 0 
4 0 0 0 0 0 0 0 0 0 0 0 0 0 0 0 0 0 0 0 0 0 
7 0 0 0 0 0 0 0 6 7 0 0 0 0 0 0 0 0 0 0 0 0 
0 0 0 0 0 0 0 0 0 0 0 0 0 0 0 0 0 0 0 5 0 0 
0 0 0 0 0 0 0 0 0 0 0 0 0 0 0 0 0 0 0 0 0 0 
0 0 6 0 0 0 0 0 0 8 0 0 0 0 0 0 0 0 0 0 0 0 
0 0 0 0 0 0 0 0 0 8 0 0 0 0 0 0 0 0 0 0 0 0 
0 0 0 0 0 0 0 0 0 0 0 0 0 0 0 0 0 0 0 0 0 0 
0 0 8 0 0 0 0 0 5 0 0 0 0 0 0 0 0 0 0 0 0 7 
## START POSITION:
138;38